२०१४-१५ रणजी करंडक ही भारतातील ८० वी प्रथम श्रेणी रणजी करंडक स्पर्धा होती. ३ गटांतील एकूण २७ संघांमध्ये ही स्पर्धा होती. कर्नाटक संघाने सलग दुसर्‍यांदा रणजी करंडक जिंकला. हे कर्नाटक संघाचे एकूण ८ वे विजेतेपद. तमिळनाडूचा संघ उपविजेता ठरला.
एकूण २७ संघ ९-९ संघांच्या ३ गटात विभागलेले आहेत. अ आणि ब गटांतील प्रत्येकी ३ संघ व क गटातील २ संघ उपांत्यपूर्व फेरीत जातील. बाद फेरीतील विजेते हे रणजी करंडक विजेते असतील. अनिर्णित सामन्यात पहिल्या डावाच्या निकालावरून बाद फेरीचे निकाल दिले जातील.
प्रत्येक संघास खालीलप्रमाणे गुण दिले जातील:
एकूण २७ संघ ३ गटांमध्ये खालीलप्रमाणे सामील करण्यात आले.

अ गट

ब गट

क गट

   पहिले तीन संघ बाद फेरीसाठी पात्र   शेवटचा संघ २०१५-१६ रणजी करंडकासाठी "ब गटात" सामिल केला जाईल.
   पहिले तीन संघ बाद फेरीसाठी पात्र   शेवटचा संघ २०१५-१६ रणजी करंडकासाठी "क गटात" सामिल केला जाईल.

   पहिले दोेन संघ बाद फेरीसाठी पात्र आणि २०१५-१६ रणजी करंडकासाठी "अ" आणि "ब" गटात सामिल 



वडोदरा वि बंगाल | वडोदरा | डिसेंबर ७-१०, २०१४बंगाल ४५५ आणि २४६/९घो ; वडोदरा ३५४सामना अनिर्णितधावफलक
कर्नाटक वि तमिळनाडू | बंगलोर | डिसेंबर ७-१०, २०१४कर्नाटक २९० आणि ३५१/५घो; तमिळनाडू २७४ आणि ८२ कर्नाटक २८५ धावांनी विजयीधावफलक
मुंबई वि जम्मू आणि काश्मीर | मुंबई | डिसेंबर ७-१०, २०१४मुंबई २३६ आणि २५४; जम्मू आणि काश्मीर २५४ आणि २३७/६ जम्मू आणि काश्मीर ४ गडी राखून विजयीधावफलक
रेल्वे वि मध्य प्रदेश | दिल्ली | डिसेंबर ७-१०, २०१४ मध्य प्रदेश १८१ आणि ३१०; रेल्वे २८० आणि ४३/३ सामना अनिर्णितधावफलक
बंगाल वि कर्नाटक | कोलकाता | डिसेंबर १४-१७, २०१४ कर्नाटक ४०८ आणि ७१/१ ; बंगाल २५१ आणि २२७ कर्नाटक ९ गडी राखून विजयीधावफलक
जम्मू आणि काश्मीर वि तमिळनाडू | दिंडीगूल | डिसेंबर १४-१६, २०१४तमिळनाडू २५४ आणि २८६/५घो; जम्मू आणि काश्मीर १३२ आणि १३१ तमिळनाडू २७७ धावांनी विजयीधावफलक
मध्य प्रदेश वि उत्तर प्रदेश | इंदूर | डिसेंबर १४-१७, २०१४ मध्य प्रदेश २९६ आणि ६३; उत्तर प्रदेश १८० आणि १८३/६ उत्तर प्रदेश ४ गडी राखून विजयीधावफलक
रेल्वे वि मुंबई | दिल्ली | डिसेंबर १४-१७, २०१४ रेल्वे २४२ आणि १३६/४ ; मुंबई १०१सामना अनिर्णितधावफलक
वडोदरा वि जम्मू आणि काश्मीर | वडोदरा | डिसेंबर २१-२४, २०१४ जम्मू आणि काश्मीर ४९७ आणि १४७/९ ; वडोदरा ४२६सामना अनिर्णितधावफलक
रेल्वे वि कर्नाटक | दिल्ली | डिसेंबर २१-२४, २०१४ कर्नाटक २४७ आणि १७४/५घो; रेल्वे १७१ आणि ११४ कर्नाटक १३६ धावांनी विजयीधावफलक
तमिळनाडू वि मध्य प्रदेश | चेन्नई | डिसेंबर २१-२४, २०१४ मध्य प्रदेश ४३७ आणि ११२/४ ; तमिळनाडू २४८ आणि ३६९ सामना अनिर्णितधावफलक
उत्तर प्रदेश वि मुंबई | कानपूर | डिसेंबर २१-२४, २०१४ उत्तर प्रदेश २०६ आणि १६१; मुंबई २७० आणि ९८/२ मुंबई ८ गडी राखून विजयीधावफलक
अ गट: बंगाल वि मुंबई | कोलकाता | डिसेंबर २८-३१, २०१४ मुंबई ४१४; बंगाल २१० आणि १२९/० सामना अनिर्णितधावफलक
मध्य प्रदेश वि वडोदरा | ग्वाल्हेर | डिसेंबर २८-३१, २०१४ वडोदरा ३५८; मध्य प्रदेश १७८ आणि ११९/६ सामना अनिर्णितधावफलक
तमिळनाडू वि रेल्वे | चेन्नई | डिसेंबर २८-३१, २०१४ तमिळनाडू २१३ आणि १३३/३घो ; रेल्वे २३६सामना अनिर्णितधावफलक
उत्तर प्रदेश वि जम्मू आणि काश्मीर | कानपूर | डिसेंबर २८-३१, २०१४ उत्तर प्रदेश २९९/५घो; जम्मू आणि काश्मीर १९९/८ सामना अनिर्णितधावफलक
बंगाल वि तमिळनाडू | कोलकाता | जानेवारी ५-८, २०१५ तमिळनाडू २४६ आणि ३२७/५ ; बंगाल ४५४/९घोसामना अनिर्णितधावफलक
कर्नाटक वि जम्मू आणि काश्मीर | हुबळी | जानेवारी ५-७, २०१५ जम्मू आणि काश्मीर १६० आणि २३३ ; कर्नाटक ४२३/९घोकर्नाटक १ डाव आणि ३० धावांनी विजयीधावफलक
मुंबई वि मध्य प्रदेश | मुंबई | जानेवारी ५-८, २०१५ मुंबई ४०४ आणि ३११/४ ; मध्य प्रदेश ५३८/७घोसामना अनिर्णितधावफलक
उत्तर प्रदेश वि वडोदरा | लखनौ | जानेवारी ५-८, २०१५ वडोदरा ४९८ आणि ३३/० ; उत्तर प्रदेश २२३ आणि ३०७ वडोदरा १० गडी राखून विजयीधावफलक
बंगाल वि जम्मू आणि काश्मीर | कोलकाता | जानेवारी १३-१६, २०१५बंगाल ३८७ आणि २६४/५घो; जम्मू आणि काश्मीर ३१५ आणि २१९/२ सामना अनिर्णितधावफलक
मध्य प्रदेश वि कर्नाटक | इंदूर | जानेवारी १३-१६, २०१५ मध्य प्रदेश ३०३ आणि २७७/३ ; कर्नाटक ५२२सामना अनिर्णितधावफलक
रेल्वे वि वडोदरा | दिल्ली | जानेवारी १३-१६, २०१५ वडोदरा २९८ आणि २४०/५ ; रेल्वे २६३सामना अनिर्णितधावफलक
तमिळनाडू वि उत्तर प्रदेश | चेन्नई | जानेवारी १३-१५, २०१५ उत्तर प्रदेश १८२ आणि १६९ ; तमिळनाडू ४००तमिळनाडू १ डाव आणि ४९ धावांनी विजयीधावफलक
जम्मू आणि काश्मीर वि रेल्वे | दिल्ली | जानेवारी २१-२४, २०१५ रेल्वे २३४/५घो आणि १८/० ; जम्मू आणि काश्मीर ११४सामना अनिर्णितधावफलक
कर्नाटक वि वडोदरा | मैसूर | जानेवारी २१-२४, २०१५ वडोदरा ३३५ आणि २५४; कर्नाटक ३०२ आणि १५३/७ सामना अनिर्णितधावफलक
तमिळनाडू वि मुंबई | चेन्नई | जानेवारी २१-२३, २०१५ मुंबई १४१ आणि २३२ ; तमिळनाडू ४१७तमिळनाडू १ डाव आणि ४४ धावांनी विजयीधावफलक
उत्तर प्रदेश वि बंगाल | गाझियाबाद | जानेवारी २१-२४, २०१५ बंगाल १४१/४ सामना अनिर्णितधावफलक
जम्मू आणि काश्मीर वि मध्य प्रदेश | इंदूर | जानेवारी २९-फेब्रुवारी १, २०१५ मध्य प्रदेश ३७१; जम्मू आणि काश्मीर १७७ आणि ९७मध्य प्रदेश १ डाव आणि ९७ धावांनी विजयीधावफलक
वडोदरा वि मुंबई | वडोदरा | जानेवारी २९-फेब्रुवारी १, २०१५ मुंबई २८७ आणि ३०४/९घो; वडोदरा १८४ आणि २३८ मुंबई १६९ धावांनी विजयीधावफलक
बंगाल वि रेल्वे | कोलकाता | जानेवारी २९-फेब्रुवारी १, २०१५ बंगाल २६८ आणि २९८/८घो; रेल्वे ३०२ आणि १९८/८ सामना अनिर्णितधावफलक
कर्नाटक वि उत्तर प्रदेश | बंगलोर | जानेवारी २९-फेब्रुवारी १, २०१५ कर्नाटक ७१९/९घो आणि २१५; उत्तर प्रदेश २२० आणि ४२/२ सामना अनिर्णितधावफलक
वडोदरा वि तमिळनाडू | वडोदरा | फेब्रुवारी ६-९, २०१५ वडोदरा १४९ व २४५; तमिळनाडू १८८ व २०७/३ तमिळनाडू ७ गडी राखून विजयीधावफलक
मध्य प्रदेश वि बंगाल | इंदूर | फेब्रुवारी ६-९, २०१५ मध्य प्रदेश ५१४/६घो; बंगाल २१९ व ३०३/८ सामना अनिर्णितधावफलक
मुंबई वि कर्नाटक | मुंबई | फेब्रुवारी ६-९, २०१५ मुंबई ४३६ व २२३/८घो; कर्नाटक ४१५ व ११०/१ सामना अनिर्णितधावफलक
रेल्वे वि उत्तर प्रदेश | TBA | फेब्रुवारी ६-९, २०१५ रेल्वे ३४५ व १८९; उत्तर प्रदेश २९२ व २४६/३ उत्तर प्रदेश ७ गडी राखून विजयीधावफलक
दिल्ली वि सौराष्ट्र | दिल्ली | डिसेंबर ७-१०, २०१४दिल्ली ४४२ आणि १९/१ ; सौराष्ट्र २१७ आणि २४० दिल्ली ९ गडी राखून विजयीधावफलक
महाराष्ट्र वि ओरिसा | पुणे | डिसेंबर ७-१०, २०१४ओरिसा ३११ आणि १७८/५ ; महाराष्ट्र ३७१सामना अनिर्णीतधावफलक
 पंजाब वि हरियाणा | पटियाला | डिसेंबर ७-१०, २०१४ पंजाब २७३ आणि ३३०/६घो; हरियाणा २८३ आणि २०० पंजाब १२० धावांनी विजयीधावफलक
 राजस्थान वि गुजरात | जयपूर | डिसेंबर ७-१०, २०१४गुजरात ३४० आणि २६६/७घो; राजस्थान १९५ आणि २७१/८ सामना अनिर्णितधावफलक
 हरियाणा वि महाराष्ट्र | रोहतक | डिसेंबर १४-१७, २०१४हरियाणा १३६ आणि १७६; महाराष्ट्र १०५ आणि १५४ हरियाणा ५३ धावांनी विजयीधावफलक
 ओरिसा वि गुजरात | कटक | डिसेंबर १४-१७, २०१४ ओरिसा २२५ आणि २४८; गुजरात ३७२ आणि १०५/२ गुजरात ८ गडी राखून विजयीधावफलक
 राजस्थान वि सौराष्ट्र | जयपूर | डिसेंबर १४-१७, २०१४ राजस्थान ४३७/५घो; सौराष्ट्र २६९ आणि ११७/३ सामना अनिर्णितधावफलक
 विदर्भ वि पंजाब | नागपूर | डिसेंबर १४-१७, २०१४ पंजाब १९५ आणि २५५; विदर्भ १५८ आणि १४३/३ सामना अनिर्णितधावफलक
 दिल्ली वि राजस्थान | दिल्ली | डिसेंबर २१-२४, २०१४ राजस्थान १४१ आणि २३२ ; दिल्ली ३८०/६घोदिल्ली १ डाव आणि ७ धावांनी विजयीधावफलक
 हरियाणा वि विदर्भ | रोहतक | डिसेंबर २१-२४, २०१४ विदर्भ १५४ आणि २३/२ ; हरियाणा १५६सामना अनिर्णितधावफलक
 महाराष्ट्र वि पंजाब | पुणे | डिसेंबर २१-२४, २०१४ महाराष्ट्र २१० आणि ३८४; पंजाब ३९१ आणि २०५/७ पंजाब ३ गडी राखून विजयीधावफलक
 सौराष्ट्र वि गुजरात | राजकोट | डिसेंबर २१-२४, २०१४ सौराष्ट्र २०७ आणि ३६४/५घो; गुजरात २४८ आणि १३०/२ सामना अनिर्णितधावफलक
 दिल्ली वि गुजरात | दिल्ली | डिसेंबर २८-३१, २०१४ दिल्ली ४२५/६घो; गुजरात १५० आणि १६६ दिल्ली १ डाव आणि १०९ धावांनी विजयीधावफलक
 हरियाणा वि ओरिसा | रोहतक | डिसेंबर २८-३१, २०१४ हरियाणा १२७ आणि १४३; ओरिसा २३२/९घो आणि ४१/३ ओरिसा ७ गडी राखून विजयीधावफलक
 राजस्थान वि विदर्भ | जयपूर | डिसेंबर २८-३१, २०१४ विदर्भ २९६ आणि २९६/४घो; राजस्थान १८८ आणि २३६/७ सामना अनिर्णितधावफलक
 सौराष्ट्र वि पंजाब | राजकोट | डिसेंबर २८-३१, २०१४ पंजाब ६५९/७घो आणि १५/० ; सौराष्ट्र ५५९सामना अनिर्णितधावफलक
 हरियाणा वि दिल्ली | रोहतक | जानेवारी ५-८, २०१५ दिल्ली २७८ आणि १३४/५ ; हरियाणा १८८सामना अनिर्णितधावफलक
 ओरिसा वि विदर्भ | संबलपूर | जानेवारी ५-८, २०१५ विदर्भ २४० आणि १६५/२घो; ओरिसा १३७/९घो आणि ११७/६ सामना अनिर्णितधावफलक
 राजस्थान वि पंजाब | जयपूर | जानेवारी ५-८, २०१५ राजस्थान ४३३ आणि ९३/१ ; पंजाब २७४ आणि २४७ राजस्थान ९ गडी राखून विजयीधावफलक
 सौराष्ट्र वि महाराष्ट्र | राजकोट | जानेवारी ५-८, २०१५ महाराष्ट्र ५१९; सौराष्ट्र २७३ आणि १९८ महाराष्ट्र १ डाव आणि ४८ धावांनी विजयीधावफलक
 दिल्ली वि ओरिसा | दिल्ली | जानेवारी १३-१५, २०१५ दिल्ली ३५३; ओरिसा ११८ आणि ८५ दिल्ली १ डाव आणि १५० धावांनी विजयीधावफलक
 गुजरात वि पंजाब | अहमदाबाद | जानेवारी १३-१६, २०१५ गुजरात ५१३/८घो; पंजाब ३६२ आणि १२०/१ सामना अनिर्णितधावफलक
 महाराष्ट्र वि राजस्थान | पुणे | जानेवारी १३-१५, २०१५ राजस्थान २७० आणि १०६; महाराष्ट्र २७४ आणि १०५/१ महाराष्ट्र ९ गडी राखून विजयीधावफलक
 विदर्भ वि सौराष्ट्र | नागपूर | जानेवारी १३-१६, २०१५ विदर्भ ५८३/९घो आणि ११६/२ ; सौराष्ट्र ३०९सामना अनिर्णितधावफलक
 गुजरात वि विदर्भ | सुरत | जानेवारी २१-२४, २०१५ विदर्भ २३६ आणि ३०७/८घो; गुजरात २४८ आणि १७५ विदर्भ १२० धावांनी विजयीधावफलक
 महाराष्ट्र वि दिल्ली | पुणे | जानेवारी २१-२४, २०१५ महाराष्ट्र ३३० आणि ३६६; दिल्ली ३०७ आणि ७८/३ सामना अनिर्णितधावफलक
 ओरिसा वि राजस्थान | बालंगीर | जानेवारी २१-२३, २०१५ राजस्थान ३०५ आणि ४२/० ; ओरिसा १४४ आणि १९९ राजस्थान १० गडी राखून विजयीधावफलक
 सौराष्ट्र वि हरियाणा | राजकोट | जानेवारी २१-२३, २०१५ सौराष्ट्र २३८ आणि २१३; हरियाणा २२६ आणि १६३ सौराष्ट्र ६२ धावांनी विजयीधावफलक
 गुजरात वि महाराष्ट्र | वलसाड | जानेवारी २९-फेब्रुवारी १, २०१५ गुजरात ४२९; महाराष्ट्र २६२ व ४२९/३घो सामना अनिर्णितधावफलक
 हरियाणा वि राजस्थान | रोहतक | जानेवारी २९-३१, २०१५ हरियाणा ३७३; राजस्थान १८० आणि ७४ हरियाणा १ डाव आणि ११९ धावांनी विजयीधावफलक
 पंजाब वि ओरिसा | मोहाली | जानेवारी २९-फेब्रुवारी १, २०१५ पंजाब १६७ व १४१; ओरिसा १८३ व १२७/४ ओरिसा ६ गडी राखून विजयीधावफलक
 विदर्भ वि दिल्ली | नागपूर | जानेवारी २९-फेब्रुवारी १, २०१५ विदर्भ ३७०; दिल्ली १५४ व १२३ विदर्भ १ डाव आणि ९३ धावांनी विजयीधावफलक
 गुजरात वि हरियाणा | अहमदाबाद | फेब्रुवारी ६-९, २०१५ हरयाणा १२९ व ११०; गुजरात १२५ व ११५/१ गुजरात ९ गडी राखून विजयीधावफलक
 महाराष्ट्र विदर्भ | पुणे | फेब्रुवारी ६-९, २०१५ महाराष्ट्र ३४२ व १६८/४ ; विदर्भ ११४ व ३९१ महाराष्ट्र ६ गडी राखून विजयीधावफलक
 ओरिसा वि सौराष्ट्र | कटक | फेब्रुवारी ६-९, २०१५ सौराष्ट्र २१८ व १५२; ओरिसा ८८ व २८३/८ ओरिसा २ गडी राखून विजयीधावफलक
 पंजाब वि दिल्ली | पटियाला | फेब्रुवारी ६-९, २०१५ दिल्ली २४९ व १९२; पंजाब २६३ व ८८ दिल्ली ९० धावांनी विजयीधावफलक
 आंध्रा वि हैदराबाद | विशाखापट्टणम | डिसेंबर ७-१०, २०१४हैदराबाद ५२२; आंध्रा ३६९ आणि २१५/२ सामना अनिर्णितधावफलक
 आसाम वि त्रिपुरा | गुवाहाटी | डिसेंबर ७-९, २०१४त्रिपुरा १३५ आणि १५५; आसाम २७५ आणि १८/० आसाम १० गडी राखून विजयीधावफलक
क गट : केरळ वि गोवा | वायंद | डिसेंबर ७-१०, २०१४गोवा ३६७ आणि १७९/१ ; केरळ ३९३सामना अनिर्णीतधावफलक
 सर्विसेस वि हिमाचल प्रदेश | दिल्ली | डिसेंबर ७-१०, २०१४ सर्विसेस २२६ आणि २२४ ; हिमाचल प्रदेश ४७९हिमाचल प्रदेश १ डाव आणि २९ धावांनी विजयीधावफलक
 आंध्रा वि केरळ | विझीयानगरम | डिसेंबर १४-१७, २०१४ केरळ २२९ आणि १२९; आंध्रा १४१ आणि २२१/३ आंध्रा ७ गडी राखून विजयीधावफलक
 आसाम वि झारखंड | गुवाहाटी | डिसेंबर १४-१७, २०१४ आसाम १९१ आणि २३५/९घो; झारखंड२१७ आणि ७८/४ सामना अनिर्णितधावफलक
 हैदराबाद वि गोवा | हैदराबाद | डिसेंबर १४-१७, २०१४हैदराबाद ५६८/७घो; गोवा २६९ आणि १८१/२ सामना अनिर्णितधावफलक
 सर्विसेस वि त्रिपुरा | दिल्ली | डिसेंबर १४-१७, २०१४ त्रिपुरा ४३०; सर्विसेस ३६८/२ सामना अनिर्णितधावफलक
 गोवा वि हिमाचल प्रदेश | पोरवोरीम | डिसेंबर २१-२४, २०१४ गोवा ३५७ आणि १८४ ; हिमाचल प्रदेश ३८१सामना अनिर्णितधावफलक
 झारखंड वि त्रिपुरा | धनबाद | डिसेंबर २१-२४, २०१४ झारखंड १४२ आणि ४०९/८घो; त्रिपुरा ३६२ आणि १२/० सामना अनिर्णितधावफलक
 केरळ वि हैदराबाद | वायंद | डिसेंबर २१-२४, २०१४ हैदराबाद २७० आणि २४९/१ ; केरळ ४४७/७घोसामना अनिर्णितधावफलक
 सर्विसेस वि आंध्रा | दिल्ली | डिसेंबर २१-२४, २०१४ आंध्रा २३४ आणि १९/१ ; सर्विसेस २८६सामना अनिर्णितधावफलक
 आसाम वि हिमाचल प्रदेश | गुवाहाटी | डिसेंबर २८-३१, २०१४ हिमाचल प्रदेश ५४९/४घो; आसाम २१८ आणि १९८ हिमाचल प्रदेश १ डाव आणि १३३ धावांनी विजयीधावफलक
 हैदराबाद वि सर्विसेस | हैदराबाद | डिसेंबर २८-३१, २०१४ सर्विसेस ३०६ आणि २८५; हैदराबाद ३३८ आणि ५२/१ सामना अनिर्णितधावफलक
 झारखंड वि केरळ | धनबाद | डिसेंबर २८-३१, २०१४ झारखंड३३७ आणि ३३७/५ ; केरळ ३८३सामना अनिर्णितधावफलक
 त्रिपुरा वि गोवा | आगरताळा | डिसेंबर २८-३१, २०१४ गोवा २५१ आणि २३८/९घो; त्रिपुरा २६५ आणि ११३/१ सामना अनिर्णितधावफलक
 आंध्रा वि झारखंड | विझीयानगरम | जानेवारी ५-८, २०१५ झारखंड२४६ आणि १०४; आंध्रा ३०४ आणि ४७/१ आंध्रा ९ गडी राखून विजयीधावफलक
 आसाम वि सर्विसेस | गुवाहाटी | जानेवारी ५-७, २०१५ सर्विसेस ११३ आणि १७०; आसाम २५७ आणि २७/५ आसाम ५ गडी राखून विजयीधावफलक
 हिमाचल प्रदेश वि केरळ | धरमशाला | जानेवारी ५-८, २०१५ केरळ १९६ आणि २५२/८ ; हिमाचल प्रदेश ५१७सामना अनिर्णितधावफलक
 त्रिपुरा वि हैदराबाद | आगरताळा | जानेवारी ५-८, २०१५ त्रिपुरा १८४ आणि ३५१; हैदराबाद ४९१/९घो आणि ४८/१ हैदराबाद ९ गडी राखून विजयीधावफलक
 आंध्रा वि त्रिपुरा | ओंगल | जानेवारी १३-१५, २०१५ त्रिपुरा १५१ आणि १५१ ; आंध्रा ३१०आंध्रा १ डाव आणि ८ धावांनी विजयीधावफलक
 हिमाचल प्रदेश वि झारखंड | धरमशाला | जानेवारी १३-१६, २०१५ हिमाचल प्रदेश ३०४ आणि ९१/६ ; झारखंड २३२सामना अनिर्णितधावफलक
 हैदराबाद वि आसाम | हैदराबाद | जानेवारी १३-१६, २०१५ आसाम ३९३; हैदराबाद २१५ आणि १२२ आसाम १ डाव आणि ५६ धावांनी विजयीधावफलक
 सर्विसेस वि गोवा | दिल्ली | जानेवारी १३-१६, २०१५ गोवा ३०४ आणि २६/० ; सर्विसेस ३८१सामना अनिर्णितधावफलक
 गोवा वि आसाम | पोरवोरीम | जानेवारी २१-२४, २०१५ गोवा १७५ आणि २६८; आसाम ४३५/८घो आणि १२/० आसाम १० गडी राखून विजयीधावफलक
 हिमाचल प्रदेश वि आंध्रा | धरमशाला | जानेवारी २१-२४, २०१५ आंध्रा ३३६/८घो; हिमाचल प्रदेश १८६/७ सामना अनिर्णितधावफलक
 झारखंड वि हैदराबाद | रांची | जानेवारी २१-२४, २०१५ झारखंड५५६/९घो आणि १८९/४घो; हैदराबाद ४५५ आणि ७/० सामना अनिर्णितधावफलक
 त्रिपुरा वि केरळ | आगरताळा | जानेवारी २१-२४, २०१५ त्रिपुरा १७९ आणि २९५/९ ; केरळ ३०१/९घोसामना अनिर्णितधावफलक
 आसाम वि आंध्रा | गुवाहाटी | जानेवारी २९-फेब्रुवारी १, २०१५ आंध्रा १३७ आणि १९८; आसाम ३१२ आणि २५/० आसाम १० गडी राखून विजयीधावफलक
 गोवा वि झारखंड | पोरवोरीम | जानेवारी २९-फेब्रुवारी १, २०१५ झारखंड ३८५ आणि ५५/२ ; गोवा २१५ आणि २२३झारखंड ८ गडी राखून विजयीधावफलक
 हिमाचल प्रदेश वि त्रिपुरा | आगरताळा | जानेवारी २९-फेब्रुवारी १, २०१५ हिमाचल प्रदेश ५३५/५घो; त्रिपुरा ३४६ आणि २३९ सामना अनिर्णितधावफलक
 केरळ वि सर्विसेस | कन्नूर | जानेवारी २९-फेब्रुवारी १, २०१५ केरळ ४८३ व १०/१ ; सर्विसेस ३१८ व १७४ धावफलक
 आंध्रा वि गोवा | ओंगोल | फेब्रुवारी ६-९, २०१५ आंध्रा ५४८/५घो; गोवा १९८ व २१४ आंध्रा १ डाव आणि १३६ धावांनी विजयीधावफलक
 हैदराबाद वि हिमाचल प्रदेश | हैदराबाद | फेब्रुवारी ६-९, २०१५ हिमाचल प्रदेश ५११; हैदराबाद ५२४/५सामना अनिर्णितधावफलक
 केरळ वि आसाम | कन्नूर | फेब्रुवारी ६-९, २०१५ आसाम ३४४ व १८८/६ ; केरळ २६६सामना अनिर्णितधावफलक
 सर्विसेस वि झारखंड | जमशेदपुर| फेब्रुवारी ६-९, २०१५सर्विसेस २३० व २३५; झारखंड ३८७ व ८४/१ झारखंड ९ गडी राखून विजयीधावफलक
