आकाशात असणाऱ्या विविध तारकांच्या किंवा तारकापुंजांच्या नावांचा हा मराठी-इंग्रजी कोश :
अंकनी : Norma
अगस्ती : Canopus
अंगिरस : Epsilon of Ursa Major, Alioth
अंगुष्ठ : Beta Corvi
अग्नि : Beta of Tauri
अग्रनद : Achernar
अग्ऱय तारा : Primary Star
अतिनवतारा : Supernova
अत्रि : Delta Ursae Majoris, Megrez
अधिक्रमण : बुधाचे किंवा शुक्राचे सू्र्यासमोरून जाणे : Transit 
अनुराधा : Delta Scorpii
अनुराधा : Beta and Delta Scorpii
अपोलो : Apollo हा तारा नाही. 
अंबा : Alcyone
अभिजित : Vega
अभ्रयंती : Maia
अभ्रिका : Nebula
अरित्र : Puppis
अरुंधती : Alcor
अरुंधती केश : Coma Berenices
अलगद : Alpha Hydrae; Cor Hydrae; Hydrus
अल्गोल : Beta Persei
अशनी : Shooting Star
अश्मंत : Fornax
अश्वत्थपत्र : Cor Coroli
अश्वमुख : Equuleus
अश्वशिर अभ्रिका : Horsehead Nebula
अश्विनी : Alpha Arietis
अश्विनीकुमार : Castor and Pollux; Alpha and Beta Geminii
अष्टक : Octans
असिद्रंष्ट : Dorado
अस्रप : : Epsilon and Lambda Scorpii
आकाशगंगा : Milky Way; Galaxy
आग्नेय : Eata Tauri
आपस्‌ : Gamma Verginis
आर्द्रा : Athena; Gamma Geminorum
आल्फार्ड : Alphard
आश्लेषा : Zeta Hydrae
इंद्र : Delta Ursae Minoris
उच्चैःश्रवा : Pegasus
उत्तर कदंब : North Celestial Pole
उत्तर क्रूस : North Cross
उत्तर त्रिकोण : Triangulum
उत्तर मुकुट : Corona Borealis 
उत्तरा : Denebola; Beta Leonis
उत्तरा भाद्रपदा : Gamma Pegasi
उत्तराषाढा : Pye Sagittarii
उंदऱ्या : Alpha Librae, Genubi
उपग्रह : Satellite
उर्वशी : Beta Lyrae; Sheliak
उल्का : Meteor; Meteorite; Shooting Star
ऋत : Beta Draconis
ऐंद्री : Anteres
कंकणाकृती : Annular 
कनिष्ठा : Aldebaran
कन्या : Virgo
कपोत : Apus
करभ : Camelopardalis
कर्क : Cancer
कर्क संक्रांत : Summer Solistice
कर्कटक : Circinus
कदंब : Celestial Pole; Pole of Ecliptic
कश : Castor
कश्यप : Mebsuta
काकुली : Lynx
कात्या : Pleiades; Seven Sisters
कारंडव : Tucana
कालयंत्र : Horologium
कालाग्नि  : Cauda Draconis, or Catabibazon 
कालेय : Draco
काक्षी : Betelgeuse
किंतारा : Quasar 
कुबेर : Pluto
कुंभ : Aquaris
कुंभ राशीतील चौथ्या क्रमांकाची दीप्ती असणारा ‘डेल्टा’ तारा : डेल्टा अक्वेरी. 
कृत्तिका : Seven Sisters; Pleiades 
कृष्णविवर : Black Hole
कृष्णाभ्रिका : Black Nebula
केतू  : Cauda Draconis, or Catabibazon 
क्रतु : Dubhe; Alpha of Ursae Majoris
क्रांतिवृत्त : Ecliptic
खग्रास : Total 
खंडग्रास : Partial 
गरुड : Aquila
गवय : Lynx
गुरु : Jupiter
गोमती : Cursa; Beta Eridani 
ग्रह : Planet
ग्रहण : Eclipse
चंद्र : Moon, Natural Satellite
चंद्रकला : Phases of Moon
चंद्रग्रहण : Lunar eclipse
चांद्र : Lunar, Relating to moon
चांद्रमास : Lunar month 
चषक : Crater
चांदणी : A celestial body appearing as a luminous point
चित्रफलक : Pictor
चित्रा : Spica
चित्रोष्ट : Camelopardalis
छायाकल्प ग्रहण : मांद्य ग्रहण, Penumbral Lunar Eclipse
जटायू : Phoenix
जंबूक : Wulpecula
जयंती : Zeta Piscium
जालक : Reticulum
जीमूत : Alpha Aquarii
जोडतारा : Double Srar; Binary Star 
ज्येष्ठा : Anteres
ज्योतिषभ्रिका : Planetary Nebula
डेल्टा ॲक्वेरी या ताऱ्याच्या जवळून होणारा उल्कावर्षाव : Delta Acqarids
ठुबान : Alpha Draconis
ढाल : Scutum
तमिस्र तारा: Dark Star
तक्षणी: Caelum
तारका : A celestial body appearing as a luminous point
तारकापुंज : Constellation 
तारा : Star
तारामंडळ : Galaxy 
ताराभ्र : Star Cloud
तिमिंगल : Cetus
तूळ : Libra
तेज:पुंजक : Bright Nebula
तेजस्क : Pulsar
तेजोमेघ : Nebula, Bright Cloud
त्रिकूट : Mensa
त्रिशंकू : Crux
त्रोटा : Tucana
दमयंती : Azelfalage; Pi Cygne
दक्षिण कदंब : South Celestial Pole
दक्षिण क्रूस : South Cross
दक्षिण त्रिकोण : Triangulum Australe
दक्षिण मत्स्य : Piscis Austrinus
दक्षिण मुकुट : Corona Australis
दीर्घिका : Galaxy
दुर्बीण : Telescopium
दुला : Electra
दूरवीक्ष : Telescopium
देवयानी : Andromeda
देवयानीतून होणारा उल्कावर्षाव : ॲन्ड्रोमीडस 
धनिष्ठा : Delphinus
धनू : Sagittarius
धर्म : Epsilon Ursae Minoris
धाता : Zeta Ursae Minoris
धूमकेतु : Comet
ध्रुवतारा : Pole Star; Polaris; Lodestar; North Star; Northern Star; Guiding Star; Alpha Ursae Minoris
ध्रुवमत्स्य : Little Bear; Ursa minor
ध्वांक्ष : Corvus; Raven
नंद : Muphrid
नरतुरंग : Centauri
नवतारा : Nova
नक्षत्र : Asterism; Constellation
नीहारिका : Diffuse Nebula
नैसर्गिक उपग्रह : Natural Satellite
नौका : Argonavis
नौकातल : Carina
नौवसन : Vela
नौशीर्ष : Vela
पारावत : Columbia
पिधान युती : Occultation = चंद्रबिंब जेव्हा एखाद्या तारकेला किंवा ग्रहाला आच्छादून पुढे जाते तेव्हा त्याला पिधान युती म्हणतात दोन ग्रहांमध्ये किंवा ग्रह आणि ताऱ्यामध्ये पिधान युती होऊ शकते.
पीठ : Ara
पुनर्वसू : Castor and Pollux; Alpha and Beta Geminii
पुलस्त्य : Gamma Ursae Majoris
पुलह : Merak; Beta Ursae Mejoris
पुष्य : Hamarein; Delta of Cancri
पूर्वा : Delta Leonis
पूर्वा भाद्रपदा : Alpha and Beta Pegasi; Markab, 
पूर्वाषाढा : Delta, Epsilon and Lambda Sagittarii
पृथ्वी : Earth
पृथ्वीसदृश ग्रह : Terestrial Planet
प्रजापति : Uranus
प्रश्वा : Procyon ; Dog Star; Alpha Canis Minoris
??? : Gomeisa ; Beta Canis Minoris
प्लक्ष : Polux
फलक : Scutum
बक : Grus
बटुग्रह : Dwarf planet
बटु तारा : Dwarf
बहुलिका : Seven Sisters; Pleiades
बुध : Mercury
बृ्हदृक्ष : Great Bear; Ursa Major; Big Dipper )
बृहस्पती : Jupitor
बृहद्‌लुब्धक : Canis Major
ब्रह्महृदय : Capella; Alpha Aurigae
ब्रह्मा : Kocab; Beta Ursae Minoris
भरणी : Arietis 
भुजंग : Serpens
भुजंगधारी : Ophiuchus
भुजंगपुच्छ : Serpens Cauda
भुजंगशीर्ष : Serpens Caput 
भूतप : Bootes
भौगा : Lynx
मकर : Capricornus
मकर संक्रांत : Winter Solistice
मंगळ : Mars
मघा : Regulus
मंद - शनी : Saturn
मंदाकिनी : Milky Way; Galaxy
मध्यमा : Gamma Corvi
मध्यवर्ती तारा : Central Star of a Zodiacal Sign
मनूची नौका : Charon's Boat
मयूर : Pavo
मरीचि : Alkaid; Benetnasch; Eta Ursae Majoris
महातारा : Giant Star
महाश्व : Pegasus
मक्षिका : Musca
मांजऱ्या : Beta and Delta Scorpii
मित्र : Rigel Kent; Alpha Centauri
मित्रक : Beta of Centauri
मिथुन : Gemini
मिथुन राशीमधून होणारा उल्कावर्षाव : जेमिनिड्स 
मिरांदा : Miranda, युरेनसच्या एकूण २७ उपग्रहांपैकी चा एक चंद्र
मीन : Pisces
मीनास्य : Formalhaut
मीर : Mira; Omicorn Ceti
मुकुटमणि : Alpha Coronae Borealis; Alphekka; Gemma
मूळ : : Epsilon and Lambda Scorpii
मृग : Orion
मृगपाद : Belatrix; Gamma Orionis
मृगराशीतून होणारा उल्कावर्षाव : ओरिओनिड्ज 
मेघयंती : Merope
मेष : Aries
मेष राशीमधून होणारा उल्कावर्षाव : एरिड्‌ज 
यम : Indus
यमुना : Eridanus
ययाती : Perseus
ययाती नक्षत्रातून होणारा उल्का वर्षाव : Perseids 
याम्य : Arietis 
युती : Conjuction 
यूरोपा : Europa
योगतारा : Main Star of a Constellation; Synodic Star
रजस्तारापुंज : Star Dust
रवि : Sun
राजन्य : Rigil
राधा : Alpha Librae, Genubi 
रास : Zodaical Sign
राहू : : Caput Draconis, or Anabibazon  
राक्षसतारा : Giant Star
रूपविकारी तारा : Variable Star
रेवती : Phantom
रोहिणी : Aldebaran
रोहिणीपुंज: Hyades
लघुग्रह : Asteroid 
लघुग्रहांचा पट्टा : Asteroid Belt
लघुलुब्धक : Canis Minor
लघुसिंह : Leo Minor
लवित्र : Sickle
लुब्धक : Sirius
 वरुण : Neptune
वर्षयंती : Atlas
वसंत संपात : Vernal Equinox
वसिष्ठ : Mizar; Zeta Ursae Majoris
वाताकर्षक : Antlia
वायुभक्षक : Chamaeleon
वासुकी : Hydra
विशाखा : Alpha Librae, Genubi
विषम चौकोन : Trapezium; Theta Orionis
वृक : Lupus
वृश्चिक : Scorpius
वृषपर्वा : Cepheus
वृषभ : Taurus
वेदिका : Ara
व्याध : Sirius; Dog Star; Alpha Canis Majoris
शततारका : Gamma Aquarii
शनि : Saturn
शफरी : Volans
शर : Sagitta
शरद संपात : Autumnal equinox
शर्मिष्ठा : Cassiopeia
शर्मिष्ठासन : Cassiopeia's Chair
शशक : Lepus
शार्ङ्गी : Antinous
शिखावल : Pavo
शिल्पकार : Sculptor
शुक : Wasat
शुक्र : Venus
शृंगाश्व : Monoceros
शेंडे नक्षत्र : Comet
शौरी : Herculus
श्यामशबल : Canes Venatici
श्रवण : Altair; Alpha Aquilae
श्रविष्ठा : Beta Dephini
श्वेत बटु : White Dwarf
षडंश : Sextans
संक्रांत : Solstice
सत्य : Etamin; Etanin; Gamma Draconis
सप्तर्षी : Big Dipper; Great Bear; Ursa Major
सरठ : Lacerta
सांध्यतारा : Evening Star; Hesper; Hesperus; Vesper
सारथी : Auriga
सिंह : Leo
सिंह राशीतून होणारा उल्का वर्षाव : लिओनिड्‌स 
सीलम : Caelum
सोम : Moon
सुरैया : Pleiades; Seven Sisters
सूर्य : Sun
सूर्यग्रहण : Solar Eclipse
सूक्ष्मदर्शी : Microscopium
सोम - चंद्र : Moon 
सौर : Solar
सौर अभ्रिका : Solar Nebula
स्पंदभास्वर : Pulsar
स्वरमंडळ : Lyra
स्वरमंडळ तारकासमूहातून होणारा उल्कावर्षाव : लिरिड्ज 
स्वाती : Alpha Boötis; Arcturus
हंस : Alpha Cygni; Deneb
हस्त : Alpha Corvi
होकायंत्र : Pyxis



